#######################################################################################################################################################################
#          =                    =                     =                                       #                                                                       #
##################################################################################===##########################=#######################################=###############
#          =                =                                         #                    =           #                                    #                         #
####=######======#####################################===##################################=################=##########################################=###############
#   =    #     =                                 #                                         = #                #                    =              =                   #
####=##################################################################################################=##############=################################################
#   = #                                                                                                   #           =         ==                                    #
####=###################################=##################################################################################################=###########################
#   =#                                   #                               =  =   =  =                                                                                  #
####=######################===###########################==############################################################################################################
#   =                           #                             #                                                                                                       #
####=#########################################=#######################=#####################====################################===####################################
#       #                                                                       #                                #                                                    #
##############################################################################################################################################=########################
#                                                                                                                #                                                    #
###################===############################################################################################################=####################################
#           =               =               #                            =     =                                                                                      #
############=###############=#############################################################=############################################################################
#   =    =           =   #                   =        =                      #      =           =         =       =     =                  =                          #
## # #=# # #=# # #=# # # # # # # # # # #=# # # = # # # # #=# # # #=# # # # # # # # # # # #=# # # #=# # # # # # # # # # # # # # # # # # # # # # # # # # # # # # # # # ##
#   =       =            # = = =                                             #      =           =         =     =       =                  =                          #
## # # # # # # # #=# # # # # # # # # # # # # # # # # # # #=# # # # # # # # # # # # # # # #=# # # # # # # # # # # # # # # # # # # # # # # # # # # # # # # # # # # # # ##
#     = =    =        =  #         =         =                               #         =        =      =      =   =   =          =               =                    #
## # # # # # # # # # # # # # # # # # # # # # # # # # # # #=# # # # # # # # # # # # # # # #=# # # # # # # # # # # # # # # # # # # # # # # # # # # # # # # # # # # # # ##
#     =                  #   =     =                                         #      =  =                  =    =        =        =               =                    #
## # # # # # #=# #=# # # # # # # # # # # # # # # # # # #=# # # # # # # # # # # # # # # # #=# # # # # # # # # # # # # # # # # # # # # # # # # # # # # # # # # # # # # ##
#           =   =     =  #         =         =   =                           #         =                  =        =    =        =               =                    #
## # = # = # # # # # # # # # = # # # # # # # # # # # # # #=# # # # # # # # # # # # # # # #=# # # #=# # # # # # # # # # # # # # # # # # # # # # # # #=# # # # # # # # ##
#       =         =   =  #             =         =                           #                =     =       =                                       =                 #
##########################################################################################################################################=############################
#%                                                                                                                                                                    #
#######################################################################################################################################################################
#                                                                                                                                                                     #
#######################################################################################################################################################################
#                                                                                                                                                                     #
#######################################################################################################################################################################
#                                                                                                                                                                     #
#######################################################################################################################################################################
#                                                                                                                                                                     #
#######################################################################################################################################################################
#                                                                                                                                                                     #
#######################################################################################################################################################################
#                                                                                                                                                                     #
#######################################################################################################################################################################
