############################
#         #                #
# @                        #
#       ####               #
#         E#               #
#       ####=              #
#                     %    #
#         #                #
############################
