############################
# SS      #                #
# @                        #
#       ####               #
#         M#               #
#       ####=              #
#                    M%    #
#         #               S#
############################
