############################
#         #                #
#                          #
#       ####               #
#          #               #
#       ####=              #
#                          #
#         #                #
############################
